####################
#                  #
#                  #
#        ###       #
#        #         #
#        #         #
#        #         #
#        #         #
#                  #
#                  #
#                  #
#                  #
#                  #
#                  #
####################